11111111111
10C00C00001
10111111101
100C1000001
100P10E1111
11111111111
