11111111111
10C000C0001
10111111101
10PC1000001
100M10E1111
11111111111
