11111111111
10000C00001
10111111101
10001000001
100P10E1111
11111111111
