11111111111
1000C000001
10111111101
10001000001
100P1E11111
11111111111
